NO assets/tests/no.xpm
SO assets/tests/so.xpm
WE assets/tests/we.xpm
EA assets/tests/ea.xpm

F 242, 222, 136
C 97, 182, 242

11111111111111111
10000000000000001
10000000000000001
10000000100000001
10000000000000001
10000000N00000001
11111111111111111