NO assets/desert_wall.xpm
SO assets/desert_wall.xpm
WE assets/desert_wall.xpm
EA assets/desert_wall.xpm

F 252, 207, 121
C 140, 102, 42

        111111111111111111111
        100000000000000000001
11111111101111100S000111111101
100000000010000000000000000001
101111111110111111111111111101
101000000000100000000000001101
101011111111101111111111101101
101010000000001000000001001101
101010111111111011111101001101
101010110000000010000001001101
101110101111111110111111001101111111111111111
 1   1 1       100000100000000000100000000001
               101111111111111111101111111101
               100000000000000000000000000001
               111111111111111111111111111111