NO assets/purple_wall.xpm
EA assets/purple_wall.xpm
SO assets/purple_wall.xpm
WE assets/Pin-location.xpm
F 100, 26, 168
C 188, 134, 237

111111111
1000000001
1000011111
1000E1
1000001111
1000000001
111111111