NO n.xpm
SO s.xpm
WE w.xpm
EA e.xpm
F 10,20,30
C 40,50,60

111111111
100000001
1000E1
100000001
111111111