F 0,0,0

NO ./n.xpm
EA ./e.xpm

C 255,255,255
SO ./s.xpm
WE ./w.xpm


11111
10001
10N01
10001
11111