F 0,0,0

NO assets/desert_wall.xpm
EA assets/desert_wall.xpm

C 0,0,0
SO assets/desert_wall.xpm
WE assets/desert_wall.xpm


11111111111111111111111111111111111111111111111111111111111111111111111111111111111111111111111111111
1E000000000000000000000000000000000000000000000000000000000000000000000000000000000000000000000000001
11111111111111111111111111111111111111111111111111111111111111111111111111111111111111111111111111111