NO n.xpm
SO s.xpm
WE w.xpm
EA e.xpm
F 0,0,0
C 255,255,255

111111
100001
1000N0
100001
111101