NO n.xpm
SO s.xpm
WE w.xpm
EA e.xpm
F 0,0,0
C 255,255,255

111111
10A0N1
100001
111111