NO n.xpm
SO s.xpm
WE w.xpm
EA e.xpm
F 0,0,0
C 255,255,255

111111
1000N1
1000S1
111111